20 20
#####S##############
.####.##############
.####.######$#######
.####.######.#######
.####...............
.##.#...............
.##.#..#####.######.
.##.#..#####.######.
.##.#............*#.
.##.#..#####.######.
.............######.
.##.#..#.###.######.
.##.#..#.###.######.
.##.#..#.###.######.
.##.#..#.###.######.
.##.#..#.###.######.
.##.#..#.###.######.
.........###.######.
#######..###.######.
######E.............
